0 0 0 1 2 1 2 1 1 2 0 0 0
0 2 2 3 2 6 6 2 2 4 2 3 0
1 4 6 2 1 6 6 2 1 2 6 2 6
6 3 2 4 2 6 6 3 2 4 2 4 2
5 2 1 2 1 6 6 2 1 2 1 2 1
2 4 2 4 2 6 6 5 2 4 2 6 2
1 2 1 2 1 2 2 2 5 2 1 4 1
2 3 6 3 2 1 2 1 2 3 2 5 6
6 2 1 2 1 6 6 2 1 2 2 2 1
0 4 2 2 2 6 6 3 2 5 2 4 0
0 0 0 5 1 4 1 2 1 2 0 0 0