0 0 0 1 2 1 2 6 1 2 0 0 0
0 4 2 3 2 6 5 6 2 4 2 3 0
1 2 1 2 1 2 1 2 1 2 1 2 6
2 4 2 4 2 6 6 3 2 4 2 4 2
6 2 1 2 1 4 1 2 1 2 1 2 1
2 4 2 5 2 6 2 6 2 4 2 6 2
1 2 1 2 1 2 1 2 1 2 1 4 1
2 6 6 6 2 4 2 6 2 3 2 5 6
6 2 1 2 1 5 1 2 1 2 1 2 1
0 4 2 6 2 5 2 3 2 5 2 4 0
0 0 0 5 1 6 1 2 1 2 0 0 0


가로 13칸
세로 11칸

0 기본 타일

1 빨간 블록 	2 주황 블록
3 빨간 집	4 파란 집	5 노란 집
6 나무